WWWWWWWWWW
.........W
.WWWWWWW.W
.W.....W.W
.W.WWW.W.W
.W.W.W.W.W
.W.W...W.W
.W.WWWWW.W
.W.......W
.WWWWWWWWW